10
-.-.-.-.-.P.-.-.-.-
-.-.W.-.-.-.-.-.G.-
-.-.-.-.-.-.P_G.-.-.-
-.-.-.P.-.-.-.-.-.-
-.W.-.-.-.-.-.-.-.-
-.-.-.-.-.H_P.-.-.-.-
-.-.-.-.-.-.-.-.-.-
-.-.P.-.-.-.-.-.-.-
-.-.-.-.-.P_G.-.-.-.-
A.-.-.-.-.-.-.-.-.-
